111111111111111111111111111111111
10C10000001C000000001000000000001
1P000111100000000010010C000E01001
100011E0C0110001C0000000C00000001
111111111111111111111111111111111