111111111111111111111111111111111
100000000C00001111000000011000C01
100C0000000111001110000000000C001
100000000000000000C01001000000001
100001110001000000000000000000001
1000000000000E0P00000000000001111
100000011000000011100000000000001
100000011111000000000001100000001
100C0001100000000010000000000C001
1000011C0000000110000001000C00001
111111111111111111111111111111111